1111111111111111111111111111
100000000CCCCCCCCCCCCCCC0111
1111111011111111111111111111
1000000000000000001111111111
100000000000000P00CCCCC11111
1CCC011110000001011111111111
1111111111111111011111111111
100000000000000000CCCCCCC111
1E1111111111101000CCCCC11111
1000000000000000001111111111
1111111111111111111111111111
1111111111111111111111111111
1111111111111111111111111111
1111111111111111111111111111
1111111111111111111111111111
1111111111111111111111111111