1111111111111111111111111111
1110000000000000000000000001
1E11111111111111111111111101
100CC00000000000000000000001
111111111111111111111111CC01
1000000000000000000000000001
1CCCC0CCCCCCCCCCCCCCCCCC1111
1111111111111111111110000011
1000P0000000000000000000CC11
1111111111111111111111111111