11111111111111111111
1E0000001CC111111111
11111101110000000001
10000000000000000001
1CCCCCCCCC1111111111
10011111111111111C11
10000001111111111011
11111100000000000001
111111111CCCC1111111
10000000000000P11111
11111111111111111111