111111111111111111111111111
1111111E0000000000000000001
111111011111110000000000001
111111CCCCCCCCCCCCCCCC11111
100000000000000000000000001
111111111111111111111111101
100000111111111111111111101
111110111111111111111111101
100000000000000001111111P01
101101111111101111111CCCCC1
100000000000000000000000001
111111111111111111111111101
100000000000000000000000001
100000CCCCCCCCCCC1111111111
111111111111111111111111111